111111111111111111111111111
100000000000001000000000001
101111111111101110111111101
100000001000100010000010001
111111101010111011101110101
100000101010001010101000101
101110101011101010101011111
100010001000100010001000001
101011111110111111101111101
101000100000000000100010101
101110111111111110111010101
100010000000000010100010101
111011111111111010111010101
100010000000100010001000101
101111111010101111101111101
101000000010101000100000101
101011111111101011111110101
100010000000001000000000001
111111111111111111111111111