11111111111111111111
10000000100010001001
11101110101010111101
10101010001010100001
10001011101010101011
11101000001000001001
10001111101111111001
10111000101000001001
10100010101001101001
10111110101111101001
10000000100000001001
11111111111111111111