11111111111111111111111
10000000000010000000001
11111101111111110111101
10000101000000010100001
11101101111110110101101
11101100000000000101001
10000111110111111101001
10010100010100000001101
11110101110111111100101
10000100000100000110101
10111111111100000000001
10100000000111111111101
10101110000100000000101
10101011110111101111101
10001000000000000000001
11111111111111111111111